#########
#S..#...#
#.#.#.#.#
#.###.#.#
#.....#F#
#########